{
    "row":7,
    "col":7,
    "cells":[
               1,1,1,1,1,1,1,
                1,1,1,1,1,1,1,
                1,1,1,1,1,1,1,
                1,1,1,1,1,1,1,
                1,1,1,1,1,1,1,
                1,1,1,1,1,1,1,
                1,1,1,1,1,1,1
               
             ]
}